Maze 1: (15 x 15)
{{0,0,0,0,0,0,0,0,0,0,0,0,0,0,0},
{0,1,1,1,1,1,1,1,1,1,1,1,1,1,0},
{0,1,1,0,0,1,0,0,0,1,0,0,0,1,0},
{0,1,1,1,0,1,0,1,0,1,0,1,0,1,0},
{0,1,0,1,0,1,0,1,0,0,0,1,0,1,0},
{0,1,0,1,0,1,0,1,1,1,1,1,0,1,0},
{0,1,0,1,0,0,0,1,0,0,0,1,0,1,0},
{0,1,0,1,1,1,1,1,0,1,0,1,0,1,0},
{0,1,0,0,0,0,0,0,0,1,0,1,0,1,0},
{0,1,0,1,1,1,1,1,1,1,0,1,0,1,0},
{0,1,0,1,0,0,0,1,0,0,0,1,0,1,0},
{0,1,0,1,0,1,0,1,1,1,1,1,0,1,0},
{0,1,0,0,0,1,0,0,0,0,0,0,0,1,0},
{0,1,1,1,1,1,1,1,1,1,1,1,1,1,0},
{0,0,0,0,0,0,0,0,0,0,0,0,0,0,0}}

Maze 2: (15 x 15)
{{0,0,0,0,0,0,0,0,0,0,0,0,0,0,0},
{0,1,1,1,1,1,1,1,1,1,1,1,1,1,0},
{0,1,1,1,0,0,0,0,0,0,0,0,0,1,0},
{0,1,0,1,0,1,0,1,1,1,1,1,0,1,0},
{0,1,0,1,0,1,0,0,0,0,0,1,0,1,0},
{0,1,0,1,1,1,1,1,1,1,0,1,1,1,0},
{0,1,0,1,0,0,0,0,0,1,0,0,0,1,0},
{0,1,0,1,0,1,1,1,0,1,0,1,0,1,0},
{0,1,0,1,0,1,0,0,0,1,0,1,0,1,0},
{0,1,0,1,0,1,1,1,0,1,0,1,0,1,0},
{0,1,0,1,0,0,0,1,0,1,0,1,0,1,0},
{0,1,0,1,1,1,0,1,0,1,1,1,0,1,0},
{0,1,0,0,0,0,0,1,0,0,0,0,0,1,0},
{0,1,1,1,1,1,1,1,1,1,1,1,1,1,0},
{0,0,0,0,0,0,0,0,0,0,0,0,0,0,0}}

Maze 3: (15 x 15)
{{0,0,0,0,0,0,0,0,0,0,0,0,0,0,0},
{0,1,1,1,1,1,1,1,1,1,1,1,1,1,0},
{0,1,1,0,0,0,0,0,0,1,0,0,0,1,0},
{0,1,1,1,1,1,1,1,0,1,0,1,1,1,0},
{0,1,0,0,0,0,0,1,0,1,0,0,0,1,0},
{0,1,1,1,0,1,0,1,0,1,1,1,0,1,0},
{0,1,0,0,0,1,0,1,0,0,0,1,0,1,0},
{0,1,0,1,1,1,0,1,1,1,0,1,0,1,0},
{0,1,0,0,0,1,0,0,0,1,0,1,0,1,0},
{0,1,0,1,0,1,1,1,0,1,0,1,0,1,0},
{0,1,0,1,0,1,0,0,0,1,0,1,0,1,0},
{0,1,0,1,0,1,1,1,1,1,0,1,0,1,0},
{0,1,0,1,0,0,0,0,0,0,0,0,0,1,0},
{0,1,1,1,1,1,1,1,1,1,1,1,1,1,0},
{0,0,0,0,0,0,0,0,0,0,0,0,0,0,0}}

Maze 4: (29 x 29)
{{0,0,0,0,0,0,0,0,0,0,0,0,0,0,0,0,0,0,0,0,0,0,0,0,0,0,0,0,0},
{0,1,1,1,1,1,1,1,1,1,1,1,1,1,1,1,1,1,1,1,1,1,1,1,1,1,1,1,0},
{0,1,1,1,0,0,0,0,0,1,0,0,0,1,0,0,0,1,0,0,0,0,0,0,0,1,0,1,0},
{0,1,0,1,1,1,0,1,0,1,0,1,0,1,0,1,0,1,1,1,1,1,0,1,0,1,0,1,0},
{0,1,0,0,0,1,0,1,0,0,0,1,0,0,0,1,0,0,0,1,0,0,0,1,0,0,0,1,0},
{0,1,1,1,0,1,0,1,1,1,1,1,1,1,1,1,1,1,0,1,0,1,1,1,1,1,0,1,0},
{0,1,0,1,0,1,0,1,0,0,0,0,0,1,0,0,0,1,0,1,0,1,0,0,0,1,0,1,0},
{0,1,0,1,0,1,0,1,1,1,1,1,0,1,0,1,0,1,0,1,0,1,0,1,0,1,0,1,0},
{0,1,0,1,0,1,0,0,0,0,0,1,0,0,0,1,0,1,0,1,0,0,0,1,0,1,0,1,0},
{0,1,0,1,0,1,1,1,1,1,0,1,0,1,1,1,0,1,0,1,0,1,1,1,0,1,1,1,0},
{0,1,0,1,0,0,0,0,0,0,0,1,0,0,0,1,0,0,0,1,0,0,0,1,0,0,0,1,0},
{0,1,0,1,1,1,1,1,1,1,1,1,1,1,0,1,1,1,1,1,1,1,1,1,1,1,0,1,0},
{0,1,0,1,0,0,0,1,0,0,0,0,0,1,0,1,0,0,0,0,0,0,0,0,0,1,0,1,0},
{0,1,0,1,0,1,0,1,0,1,0,1,1,1,0,1,1,1,0,1,0,1,1,1,0,1,0,1,0},
{0,1,0,0,0,1,0,0,0,1,0,0,0,1,0,0,0,1,0,1,0,0,0,1,0,0,0,1,0},
{0,1,0,1,1,1,1,1,1,1,1,1,0,1,1,1,0,1,1,1,1,1,0,1,1,1,0,1,0},
{0,1,0,1,0,0,0,0,0,0,0,0,0,1,0,0,0,1,0,0,0,0,0,1,0,0,0,1,0},
{0,1,0,1,0,1,0,1,1,1,1,1,0,1,0,1,1,1,0,1,1,1,1,1,0,1,1,1,0},
{0,1,0,1,0,1,0,1,0,0,0,1,0,1,0,1,0,0,0,1,0,0,0,1,0,0,0,1,0},
{0,1,1,1,0,1,1,1,0,1,0,1,0,1,0,1,0,1,1,1,0,1,1,1,1,1,0,1,0},
{0,1,0,0,0,1,0,0,0,1,0,1,0,1,0,1,0,1,0,1,0,0,0,0,0,0,0,1,0},
{0,1,0,1,0,1,0,1,1,1,0,1,1,1,0,1,0,1,0,1,0,1,1,1,1,1,1,1,0},
{0,1,0,1,0,1,0,1,0,1,0,0,0,0,0,1,0,1,0,1,0,1,0,0,0,0,0,1,0},
{0,1,0,1,0,1,0,1,0,1,1,1,1,1,1,1,0,1,0,1,0,1,0,1,1,1,0,1,0},
{0,1,0,1,0,1,0,1,0,0,0,0,0,0,0,1,0,1,0,0,0,1,0,1,0,0,0,1,0},
{0,1,0,1,1,1,0,1,1,1,1,1,0,1,0,1,0,1,0,1,1,1,0,1,0,1,1,1,0},
{0,1,0,0,0,0,0,0,0,0,0,0,0,1,0,0,0,1,0,0,0,0,0,1,0,0,0,1,0},
{0,1,1,1,1,1,1,1,1,1,1,1,1,1,1,1,1,1,1,1,1,1,1,1,1,1,1,1,0},
{0,0,0,0,0,0,0,0,0,0,0,0,0,0,0,0,0,0,0,0,0,0,0,0,0,0,0,0,0}}